111111111111111111111111111111111111111111111111111111111111111111
122222222222222222222222222222211222222222222222222222222222222221
122222222222222222222222222222211222222222222222222222222222222221
122222222222222222222222222222211222222222222222222222222222222221
122222222222222222222222222222211222222222222222222222222222222221
122222221111122222211111222222211222222222222222222222222222222221
122222221222222222222221222222211222222222222222222222222222222221
122222221222222222222221222222211222222222222222222222222222222221
122222221222222222222221222222211222222222222222222222222222222221
122222221222222222222221222222211222222222222222222222222222222221
122222222222222222222222222222211222222222222222222222222222222221
122222222222222112222222222222211222222222222222222222222222222221
122222222222222112222222222222211222222222222222222222222222222221
122222222222222222222222222222211222222222222222222222222222222221
122222221222222222222221222222211222222222222222222222222222222221
122222221222222222222221222222211222222222222222222222222222222221
122222221222222222222221222222211222222222222222222222222222222221
122222221222222222222221222222222222222222222222222222222222222221
122222221111122222211111222222211222222222222222222222222222222221
122222222222222222222222222222211222222222222222222222222222222221
122222222222222222222222222222211222222222222222222222222222222221
122222222222222222222222222222211222222222222222222222222222222221
122222222222222222222222222222211222222222222222222222222222222221
111111111111112111111111111111111222222222222222222222222222222221
111111111111112111111111111111111222222222222222222222222222222221
122222222222222222222222222222211222222222222222222222222222222221
122222222222222222222222222222211222222222222222222222222222222221
122222222222222222222222222222211222222222222222222222222222222221
122222222222222222222222222222211222222222222222222222222222222221
122222221111122222211111222222211222222222222222222222222222222221
122222221222222222222221222222211222222222222222222222222222222221
122222221222222222222221222222211222222222222222222222222222222221
122222221222222222222221222222211222222222222222222222222222222221
122222221222222222222221222222211222222222222222222222222222222221
122222222222222222222222222222211222222222222222222222222222222221
122222222222222112222222222222211222222222222222222222222222222221
122222222222222112222222222222211222222222222222222222222222222221
122222222222222222222222222222222222222222222222222222222222222221
122222221222222222222221222222211222222222222222222222222222222221
122222221222222222222221222222211222222222222222222222222222222221
122222221222222222222221222222211222222222222222222222222222222221
122222221222222222222221222222211222222222222222222222222222222221
122222221111122222211111222222211222222222222222222222222222222221
122222222222222222222222222222211222222222222222222211222222222221
122222222222222222222222222222211222222222222222222211222222222221
122222222222222222222222222222211222222222222222222211222222222221
122222222222222222222222222222211222222222222222222211222222222221
111111111111112111111111111111111222222222222222222211222222222221
111111111111112111111111111111111222222222222222222211222222222221
122222222222222222222222222222211222222222222222222112222222222221
122222222222222222222222222222211222222222222222221122222222222221
122222222222222222222222222222211222222222222222211222222222222221
122222222222222222222222222222211222222222222222112222222222222221
122222221111122222211111222222222222222222222221122222222222222221
122222221222222222222221222222211222222222222211222222222222222221
122222221222222222222221222222211222222222222112222222222222222221
122222221222222222222221222222211222222222221122222222222222222221
122222221222222222222221222222211222222222221122222222222222222221
122222222222222222222222222222211222222222221122222222222222222221
122222222222222112222222222222211222222222221122222222222222222221
122222222222222112222222222222211222222222221122222222222222222221
122222222222222222222222222222211222222222221122222222222222222221
122222221222222222222221222222211222222222221122222222222222222221
122222221222222222222221222222211222222222221122222222222222222221
122222221222222222222221222222211222222222221122222222222222222221
122222221222222222222221222222211222222222221122222222222222222221
122222221111122222211111222222211222222222221122222222222222222221
122222222222222222222222222222211222222222221122222222222222222221
122222222222222222222222222222211222222222222112222222222222222221
122222222222222222222222222222211222222222222211222222222222222221
122222222222222222222222222222211222222222222222112222222222222221
111111111111111111111111111111111111111111111111111111111111111111